
@@@@@@@@@@@@@@W@@@
@@@@.............@
@@@..@@@.@@@@@@..@
@@..@@@@.@@@@@..@@
@@.......@@@@@.@@@
@@@@@@@@@......@@@
@@@@@@@...@@@.@@@@
@@@@@@@.@@@@@@@@@@
@@@@@@@$@@@@@@@@@@