
@@@@W@@@@@@@@@@$@@
@@@@..@@@@@@@@@.@@
@@@..@@@.@@@@@@.@@
@@..@@@@.@@@@@..@@
@@.......@@@@@.@@@
@@@@@@@@.......@@@
@@@@@@@@..@@@.@@@@
@@@@@@@..@@@@@@@@@
@@@@@@@@@@@@@@@@@@