
7 5 2

W..@@@@
@@....@
@@@@@.@
@@@@@.@
@@....@
...@@@@
@@....@
@@.@@.@
@@.@@.@
@$....@